
___________________________________________________________________________
|XXXXXXXXXXXXXXXXXXXXXXXXXXXXXXXXXXXXXXXXXXXXXXXXXXXXXXXXXXXXXXXXXXXXXXXXX|
|XXXX      XXXXXXXXXXXXX               XXXXXXXXXXXXX       ?    X      XXX|
|XXXX      XXXXXXXXXXXXX       A       XXXXXXXXXXXXX  XXXXXXXX  X  B   XXX|
|XXXX                          O       XXXXXXXXXX      XXXXXXX         XXX|
|XXXX      XXXXXXXXXXXXX                               XXXXXXXXXXXXXXXXXXX|
|XXXXXXXXXXXXXXXXXXXXXXX               XXXXXXXXXX   C  XXXXXXXXXXXXXXXXXXX|
|XXXXXXXXXXXXXXXXXXXXXXXXXXXXX  XXXXXXXXXXXXXXXXXXXXXXXXXXXXX        XXXXX|
|XXXXXX                 XXXXXX  XXXXXXXXXXXXXXXXXXXXXXXXXXXXX   ?    XXXXX|
|XXXXXX  XXXXX  XXXX    XXXXXX  XXXXXXXXXXXXXXXXX      XXXXXX        XXXXX|
|XXXXXX  XXXXX  XXXXXXXXXXXXXX  XXXXXXXXXXXXXXXXX  D   XXXXXXXXXXXX  XXXXX|
|XXXXXX  XXXXX                                         XXXX          XXXXX|
|XXXXXX  XXXXXXXXXXXXXXXXXXXXXXXXXXXXXXXXXXXXXXXX      XXXX     XXXXXXXXXX|
|XXXXXX  XXXXXXXXXXXXXXXXXXXXXXXXXXXXXXXXXXXXXXXXXXXXXXXXXX  F  XXXXXXXXXX|
|XXXXXX       E       XXXXXXXXXXXXXXXXXXXXXXXXXXXXXXXXXXXXX     XXXXXXXXXX|
|XXXXXXXXXXXXXX                                                 XXXXXXXXXX|
|XXXXXXXXXXXXXX       XXXXXXXXXXXXXXXXXXXXXXXXXXXXXXXXXXXXXXXXXXXXXXXXXXXX|
|XXXXXXXXXXXXXXXXXXXXXXXXXXXXXXXXXXXXXXXXXXXXXXXXXXXXXXXXXXXXXXXXXXXXXXXXX|
|-------------------------------------------------------------------------|//
000000000000000000000000000000000000000000000000000000000000000000000000000
000000000000000000000000000000000000000000000000000000000000000000000000000
0000011111100000000000001111112221111110000000000000  011112234405444210000
000001112340000000000000222333333333331000000000000000000000005506544430000
0000011234r0           0l43445653343343000000000044432100000004456654430000
00000111111000000000000022233455433456r0        0l5433100000000000000000000
000000000000000000000000112345665433321000000000044432100000000000000000000
000000000000000000000000000000330000000000000000000000000000011112343000000
0000000                 000000220000000000000000000000000000012335554000000
0000000  00000  0000    000000000000000000000000013321100000013455444000000
0000000  00000  00000000000000120000000000000000034342100000000000044000000
0000000  00000               014r0              0l3442100001145r0 0l1000000
0000000  000000000000000000000000000000000000000034332100001233100000000000
0000000  000000000000000000000000000000000000000000000000001222100000000000
000000000111124454333300000000000000000000000000000000000003222100000000000
0000000000000005455655r0                                 0l5311100000000000
000000000000000543333100000000000000000000000000000000000000000000000000000
000000000000000000000000000000000000000000000000000000000000000000000000000
000000000000000000000000000000000000000000000000000000000000000000000000000
//
NOTES GO UNDERNEATH THE TWO LAYOUTS
numbers: higher numbers represent better spaces to move to
l : move left until otherwise stated
r: right ""
d: down ""
u: up ""