
XXXXXXXXXXXXXXXXXXXXXX
XXXXXXXXXXXXXXXXXXXXXX
XXXX              XXXX
XXXX              XXXX
XX       XX X       XX
XX          X       XX
XX       X          XX
XX       X XX       XX
XXXX              XXXX
XXXX              XXXX
XXXXXXXXXXXXXXXXXXXXXX
XXXXXXXXXXXXXXXXXXXXXX
//
0000000000000000000000
0000000000000000000000
0000111111441111110000
0000122443333442210000
0011333350040533331100
0044344544550554434400
0044344550554454434400
0011333350400533331100
0000122443333442210000
0000111111441111110000
0000000000000000000000
0000000000000000000000
//
22x12