
XXXXXXXXXXXXXXXXXXXXXX
XXXXXXXXX   XXXXXXXXXX
XXXXX           XXXXXX
XXX                XXX
XX        X         XX
X        XXX         X
X        XXX         X
XX        X         XX
XXX                XXX
XXXXX           XXXXXX
XXXXXXXXX   XXXXXXXXXX
XXXXXXXXXXXXXXXXXXXXXX
//
0000000000000000000000
0000000004440000000000
0000012334443321000000
0001223334543332221000
0023233333033333323200
0444334430003443344440
0444334430003443344440
0023233333033333323200
0001223334543332221000
0000012334443321000000
0000000004440000000000
0000000000000000000000
//
22x12